AAAAAAAAAAAAAAAAAAAAAAAAAAAAAAAAAAAAAAAAAAAABBBBBBBBBBBBBBBBBBBBBBBBBBBBBBBBBBBBBBBBBBBBBBBBBBBB
AAAAAAAAAAAAAAAAAAAAAAAAAAAAAAAAAAAAAAAAAAAAAAAAABBBBBBBBBBBBBBBBBBBBBBBBBBBBBBBBBBBBBBBBBBBBBBB
AAAAAAVAAAAAAAAAAAAAAAAAAAAAAAAAAAAAAAAAAAAAAAAAABBBBBBBBBBBBBBBBBBBBBBBBBSBBBBBBBBBBBBBBBBBBBBB
AAAAAAAAAAAAAAAAAAAAAAAAAAAAAAAAAAAAAAAAAAAAAAAAAAABBBBBBBBBBBBBBBBBBBBBBBBBBBBBBBBBBBBBBBBBBBBB
AAAAAAAAAAAAAAAAAAAAAAAAAAAAAAAAAAAAAAAAAAAAAAAAABBBBBBBBBBBBBBBBBBBBBBBBBBBBBBBBBBBBBBBBBBBBBBB
AAAAAAAAAAAAAAAAAAAAAAAAAAAAAAAAAAAAAAAAAAAAAAAABBBBBBBBBBBBBBBBBBBBBBBBBBBBBBBBBBBBBBBBBBBBBBBB
AAAAAAAAAAAAAAAAAAAAAAAAAAAAAAAAAAAAAAAAAAAAAABBBBBBBBBBBBBBBBBBBBBBBBBBBBBBBBBBBBBBBBBBBBBBBBBB
AAAAAAAAAAACCCCCCAAAAAAAAAAAAAAAAAAAACCCCCCCMMMMMMMMMMMMMMMMMMMMMMMMMMMCCCCCCCCCCCCCBBBBBBBBBBBB
AAAAAAACCCCCCCCCCCCCAAAAAAAAAAAAAACCCCCCCCCCCCCMMMMMMMMMMMMMMMMMMMMMZZZZZZCCCCCCCCCCCCCCCBBBBBBB
CCCCCCCCCCCCCCCCCCCCCCCCCCCCCCCCCCCCCCCCCCCCZZZZZZZZZZZQQQQQQQQQQQZZZZZZZZZZCCCCCCCCCCCCCCCCCCCC
CCCCCCCCCCCCCCCCCCCCCCCCCCCCCCCCCCCCCCCCCCCCCCZZZZZZZZZQQQQQQQQQQQZZZZZZZZZZCCCCCCCCCCCCCCCCCCCC
CCCCCCCCCCCCCCCCCCCCCCCCCCCCCCCCCCCCCCCCCCCCZZZZZZZZZZZQQQPPPPPQQQZZZZZZZZZCCCCCCCCCCCCCCCCCCCCC
CCCCCCCCCCCCCCCCCCAACCCCCCCCCCCCCCNCCCCCCCCCCCCZZZZZZZZQQQPRRRPQQQZZZZZZZZCCCCCCCCCCCCCCCCCCCCCC
CCCCCCCCCCCCCCCCAAAAAACCCCCCCCCCCCCCCCCCCCCCCZZZZZZZZZZQQQPRGRPQQQZZZZZZZZZCCCCCCCCCCCCCCCCCCCCC
CCCCCCCCCCCCCCCAAAAAAAAACCCCCCCCCCCCCCCCCCCCCZZZZZZZZZZQQQPRRRPQQQZZZZZZZZZZCCCCCCCCCCCDCCCCCCCC
CCCCCCCCCCCCCAAAAAAAAAAAAAACCCCCCCCCCCCCCCCCCZZZZZZZZZZQQQPPPPPQQQZZZZZZZZZZZCCCCCCCCCCCCCCCCCCC
CCCCCCCCCCCCCAAAAAAAAAAAAAACCCCCCCCCCCCCCCCZZZZZZZZZZZZQQQQQQQQQQQZZZZZZZZZZCCCCCCCCCCCCCCCCCCCC
CCCCCCCCCCCCCCAAAAAAAAAAACCCCCCCCCCCCCCCCCCCZZZZZZZZZZZQQQQQQQQQQQZZZZZZZZZZCCCCCCCCCCCCCCCCCCCC
