AAAAAAAAAAAAAAAAAAAAAAAAAAAAAAAAAAAAAAAAAAAABBBBBBBBBBBBBBBBBBBBBBBBBBBBBBBBBBBBBBBBBBBBBBBBBBBB
AAAAAAAVAAAAAAAAAAAAAAAAAAAAAAAAAAAAAAAAAAAAAAAAABBBBBBBBBBBBBBBBBBBBBBBBBBBBBBBBBBBBBBBBBBBBBBB
AAAAAAAAAAAAAAAAAAAAAAAAAAAAAAAAAAAAAAAAAAAAAAAAABBBBBBBBBBBBBBBBBBBBBBBBBBBBSBBBBBBBBBBBBBBBBBB
AAAAAAAAAAAAAAAAAAAAAAAAAAAAAAAAAAAAAAAAAAAAAAAAAAABBBBBBBBBBBBBBBBBBBBBBBBBBBBBBBBBBBBBBBBBBBBB
AAAAAAAAAAAAAAAAAAAAAAAAAAAAAAAAAAAAAAAAAAAAAAAAABBBBBBBBBBBBBBBBBBBBBBBBBBBBBBBBBBBBBBBBBBBBBBB
AAAAAAAAAAAAAAAAAAAAAAAAAAAAAAAAAAAAAAAAAAAAAAAABBBBBBBBBBBBBBBBBBBBBBBBBBBBBBBBBBBBBBBBBBBBBBBB
AAAAAAAAAAAAAAAAAAAAAAAAAAAAAAAAAAAAAAAAAAAAAABBBBBBBBBBBBBBBBBBBBBBBBBBBBBBBBBBBBBBBBBBBBBBBBBB
AAAAAAAAAAACCCCCCAAAAAAAAAAAAAAAAAAAACCCCCCCMMMMMMMMMMMMMMMMMMMMMMMMMMMCCCCCCCCCCCCCBBBBBBBBBBBB
AAAAAAACCCCCCCCCCCCCAAAAAAAAAAAAAACCCCCCCCCCCCCMMMMMMMMMMMMMMMMMMMMMZZZZZZCCCCCCCCCCCCCCCBBBBBBB
CCCCCCCCCCCCCCCCCCCCCCCCCCCCCCCCCCCCCCCCCCCCZZZZZZZZZZZQQQQQQQQQQQZZZZZZZZZZCCCCCCCCCCCCCCCCCCCC
CCCCCCCCCCCCCCCCCNCCCCCCCCCCCCCCCCCCCCCCCCCCCCZZZZZZZZZQQQQQQQQQQQZZZZZZZZZZCCCCCCCCCCCCCCCCCCCC
CCCCCCCCCCCCCCCCCCCCCCCCCCCCCCCCCCCCCCCCCCCCZZZZZZZZZZZQQQPPPPPQQQZZZZZZZZZCCCCCCCCCCCCCCCCCCCCC
CCCCCCCCCCCCCCCCCCAAAAAAAAAAAAAAAACCCCCCCCCCCCCZZZZZZZZQQQPRRRPQQQZZZZZZZZCCCCCCCCCCCCCCCCCCCCCC
AAAAAAAAAAAAAAAAAAAAAAAAAAAAAAAAAAAAAAAACCCCCZZZZZZZZZZQQQPRGRPQQQZZZZZZZZZCCCCCCCCCCCCCCCCCCCCC
AAAAAAAAAAAAAAAAAAAAAAAACCCCCCCCCCCCCCCCCCCCCZZZZZZZZZZQQQPRRRPQQQZZZZZZZZZZCCCCCCCCCCDCCCCCCCCC
AAAAAAAAAAAAAAAAAAAAAAAAAAACCCCCCCCCCCCCCCCCCZZZZZZZZZZQQQPPPPPQQQZZZZZZZZZZZCCCCCCCCCCCCCCCCCCC
AAAAAAAAAAAAAAAAAAAAAAAAAAACCCCCCCCCCCCCCCCZZZZZZZZZZZZQQQQQQQQQQQZZZZZZZZZZCCCCCCCCCCCCCCCCCCCC
AAAAAAAAAAAAAAAAAAAAAAAAACCCCCCCCCCCCCCCCCCCZZZZZZZZZZZQQQQQQQQQQQZZZZZZZZZZCCCCCCCCCCCCCCCCCCCC
